11111111111111111111
1P010000111100000C11
10C0011011G0011E0011
11110G1000000C111C11
1C0001C011G0100C10G1
11111111111111111111