111111111111111111
10G0100000000000C1
10CC1001GGC0000001
10P010C1C0000G0001
10C01C010000000001
110111110001111111
10CC000000000000C1
10000C0000E10000C1
111111111111111111